___________________________
___________________________
___________________________
___________________________
___________________________
___________________________
___________________________
___________________________
___________________________
___________________________
___________________________
____OOOOOOOOO______________
____OOOOOOOOO______________
____OOOOOOOOO__H___________
____OOO_____________OOO____
____OOO_____________OOO____
____OOO____/________OOO____
____OOO_____________OOO____
____OOO_____________OOO____
____OOO_____________OOO____
____________________OOO____
____________________OOO____
_______H____________OOO____
______________OOOOOOOOO____
______________OOOOOOOOO____
______________OOOOOOOOO____
___________________________
___________________________
___________________________
___________________________
___________________________
___________________________
___________________________
___________________________
___________________________
___________________________
___________________________
___________________________
___________________________
___________________________
___________________________
___________________________
___________________________
___________________________
___________________________