___________________________
___________________________
___________________________
___________________________
___________________________
___________________________
___________________________
___________________________
___________________________
___________________________
___________/_______________
___________________________
______OOO_________OOO______
______OOO_________OOO______
______OOO_________OOO______
______OOOOOOOOOOOOOOO______
______OOOOOOOOOOOOOOO______
______OOOOOOOOOOOOOOO______
___________________________
___________________________
___________________________
___________________________
___________________________
S________________________S_
___________________________
OOOOOOOOO_________OOOOOOOOO
OOOOOOOOO_________OOOOOOOOO
OOOOOOOOO_________OOOOOOOOO
_________S______S__________
___________________________
___________________________
___________________________
___________________________
___________________________
___________________________
___________________________
___________________________
___________________________
___________________________
___________________________
___________________________
___________________________
___________________________
___________________________
___________________________