___________________________
___________________________
___________________________
___________________________
___________________________
________H__________________
___________________________
___________________________
___________________________
___________________________
___________/_______________
___________________________
______OOO_________OOO______
______OOO_________OOO______
______OOO_________OOO______
______OOOOOOOOOOOOOOO______
______OOOOOOOOOOOOOOO______
______OOOOOOOOOOOOOOO______
___________________________
___________________________
___________________________
___________________________
___________________________
___________________________
_________H_________________
OOOOOOOOO_________OOOOOOOOO
OOOOOOOOO_________OOOOOOOOO
OOOOOOOOO_________OOOOOOOOO
_________H_________________
___________________________
___________________________
___________________________
___________________________
___________________________
___________________________
___________________________
___________________________
___________________________
___________________________
___________________________
___________________________
___________________________
___________________________
___________________________
___________________________