___________________________
___________________________
___________________________
___OOO_______________OOO___
V__OOO_______________OOOV__
___OOO_______________OOO___
___OOO_______________OOO___
___OOO_______________OOO___
___OOO_______________OOO___
___OOO_______________OOO___
V__OOO_______________OOOV__
___OOO_______________OOO___
___OOO_______________OOO___
___OOO_______________OOO___
___OOO_______________OOO___
___OOO_______________OOO___
V__OOO_____/_________OOOV__
___OOO_______________OOO___
___OOO_______________OOO___
___OOO_______________OOO___
___OOO_______________OOO___
V__OOO_______________OOOV__
___OOO_______________OOO___
___OOO_______________OOO___
___OOO_______________OOO___
___OOO_______________OOO___
___OOO_______________OOO___
___OOO_______________OOO___
___OOO_______________OOO___
___OOO_______________OOO___
___________________________
___________________________
___________________________
___________________________
___________________________
___________________________
___________________________
___________________________
___________________________
___________________________
___________________________
___________________________
___________________________
___________________________
___________________________