O___O___O___O___O______
O___O___O___O___O______
O___O___O___O___O______
O___O___O___O___O______
O___O___O___O___O______
O___O___O___O___O______
O___O___O___O___O______
O___O___O___O___O______
O___O___O___O___O______
O___O___O___O___O______
O___O___O___O___O______
O___O___O___O___O______
O___O___O___O___O______
O___O___O___O___O______
O___O___O___O___O______
O___O___O___O___O______
O___O___O___O___O______
O___O___O___O___O______
O___O___O___O___O______
O___O___O___O___O______
O___O___O___O___O______
O___O___O___O___O______
O___O___O___O___O______
O___O___O___O___O______
O___O___O___O___O______
O___O___O___O___O______
O___O___O___O___O______
O___O___O___O___O______
O___O___O___O___O______
O___O___O___O___O______
O___O___O___O___O______
_______________________
_______________________
____________S__________
_______________________
______S________________
_______________________
_______________________
_______________________
_______________________
_______________________
_______________________